        NO              ./maps/me.xpm
SO             ./maps/me.xpm                      
    WE                      ./maps/me.xpm                   
         EA        ./maps/me.xpm 

    F                  1,1,1
       C           200,6,111





111111111111
1000000000101
11111111100111
