        NO              ./maps/2.png                     
SO             ./maps/2.png                       
    WE                      ./maps/2.png                
         EA        ./maps/2.png 

    F                  126,204,103
       C           119,181,254

1111111
1000001
1000001
10S0101
111D101
1100001
1111111
